Kento MOMOTA=桃田贤斗
SHI Yu Qi=石宇奇
Khosit PHETPRADAB=科希特
Kantaphon WANGCHAROEN=王正干
KIDAMBI Srikanth=斯里坎特
Brice LEVERDEZ=利弗德斯
CHOU Tien Chen=周天成
Shesar Hiren RHUSTAVITO=西萨
LIEW Daren=刘国伦
Kanta TSUNEYAMA=常山干太
Sitthikom THAMMASIN=西蒂空
WONG Wing Ki Vincent=黄永祺
Jonatan CHRISTIE=乔纳坦
LU Guang Zu=陆光祖
LIN Dan=林丹
PRANNOY H. S.=普拉诺
Suppanyu AVIHINGSANON=苏庞余
PARUPALLI Kashyap=卡什亚普
WANG Tzu Wei=王子维
LEE Zii Jia=李梓嘉
Sameer VERMA=维尔马
Kazumasa SAKAI=坂井一将
LEE Cheuk Yiu=李卓耀
Kantaphon WANGCHAROEN=王高伦
Kenta NISHIMOTO=西本拳太
Anthony Sinisuka GINTING=金廷
HEO Kwang Hee=许侊熙
LEE Dong Keun=李东根
SAI PRANEETH B.=普拉尼斯
Tommy SUGIARTO=苏吉亚托
NG Ka Long Angus=伍家郎
HUANG Yu Xiang=黄宇翔
Rajiv OUSEPH=欧斯夫
Hans-Kristian Solberg VITTINGHUS=维汀哈斯
Viktor AXELSEN=安赛龙
Jan O JORGENSEN=约根森
Rasmus GEMKE=格姆克
CHEN Long=谌龙
SON Wan Ho=孙完虎
Anders ANTONSEN=安东森
Lee Chong Wei=李宗伟
LEE Chong Wei=李宗伟
TIAN Houwei=田厚威
Tanongsak SAENSOMBOONSUK=坦农萨克
Chico Aura DWI WARDOYO=奇科
CHEAM June Wei=詹俊为
CHONG Wei Feng=张崴烽
LOH Kean Yew=骆建佑
SOONG Joo Ven=宋浚洋
Ihsan Maulana MUSTOFA=穆斯托法
LEE Hyun Il=李炫一
Mark CALJOUW=马克
Victor SVENDSEN=斯文森
ZHOU Ze Qi=周泽奇
Koki WATANABE=渡边航贵
Thomas ROUXEL=鲁克赛尔
Ygor COELHO=奥得维拉
LIN Yu Hsien=林祐贤
Lucas CORVEE=科维
Kai SCHAEFER=凯·舍费尔
Xiaodong SHENG=盛晓东
Lucas CLAERBOUT=克拉尔布特
Timothy LAM=蒂莫西
Luís Enrique PEÑALVER=佩纳尔弗
Ajay JAYARAM=贾亚拉姆
Sourabh VERMA=萨拉巴
Toby PENTY=潘迪
Lakshya SEN=卡什亚普
Pablo ABIAN=阿维安
Yu IGARASHI=五十岗优
HU Yun=胡贇
Marc ZWIEBLER=兹维布勒
QIAO Bin=乔斌
Kenichi TAGO=田儿贤一
WANG Zhengming=王睁茗
Sho SASAKI=佐佐木翔
Marc ZWIEBLER=兹维布勒
WEI Nan=魏楠
Taufik HIDAYAT=陶菲克
Peter Hoeg GADE=彼得盖德
CHEN Jin=陈金
Simon SANTOSO=西蒙·桑托索
Sony Dwi KUNCORO=索尼·昆科罗
BAO Chunlai=鲍春来
PARK Sung Hwan=朴成奂
Tien Minh NGUYEN=阮天明
Boonsak PONSANA=波萨那
Choong Hann WONG=黄综翰
CHAN Yan Kit=陈仁杰
Chetan ANAND=切丹阿南
DU Pengyu=杜鹏宇
Takuma UEDA=上田拓马
Brian Yang=布莱恩·杨
Chia Hao LEE=李佳豪
SUN Fei Xiang=孙飞翔
LIN Chun-Yi=林俊易
Lino MUNOZ=利诺·穆尼奥斯
WENG Hong Yang=翁鸿阳
LIU Hai Chao=刘海超
Nicholas Robert Henson WALLER=尼古拉斯·罗伯特
LI Shi Feng=李诗沣
REN Peng Bo=任鹏嶓
Emre LALE=埃姆雷•拉莱
Karan Rajan RAJARAJAN=卡兰·拉詹·拉贾拉詹
Brian YANG=布莱恩·杨
Yehezkiel Fritz MAINAKY=叶赫泽尔


TAI Tzu Ying=戴资颖
Michelle LI=李文珊
Nitchaon JINDAPOL=金达汶
Beiwen ZHANG=张蓓雯
Saina NEHWAL=内维尔
Kirsty GILMOUR=吉尔莫
CAI Yan Yan=蔡炎炎
Line Højmark KJAERSFELDT=杰克斯菲德
Akane YAMAGUCHI=山口茜
Beatriz CORRALES=科拉莱斯
Mia BLICHFELDT=米娅
YIP Pui Yin=叶姵延
HE Bing Jiao=何冰娇
Fitriani FITRIANI=菲特安妮
Pornpawee CHOCHUWONG=磋楚沃
Busanan ONGBAMRUNGPHAN=布桑兰
Evgeniya KOSETSKAYA=科塞兹卡娅
CHEUNG Ngan Yi=张雁宜
SUNG Ji Hyun=成池铉
PUSARLA V. Sindhu=辛德胡
Soniia CHEAH=谢抒芽
Aya OHORI=大堀彩
HAN Yue=韩悦
CHEN Yu Fei=陈雨菲
LI Xue Rui=李雪芮
YEO Jia Min=杨佳敏
CHEN Xiao Xin=陈晓欣
Ratchanok INTANON=因达农
GOH Jin Wei=吴堇溦
Sayaka TAKAHASHI=高桥沙也加
Gregoria Mariska TUNJUNG=玛丽斯卡
Nozomi OKUHARA=奥原希望
Hsuan-Yu Wendy CHEN=陈煊渝
JI Shu Ting=吉淑婷
KIM Hyo Min=金效旻
KIM Ga Eun=金在恩
DENG Joy Xuan=邓旋
Ayumi MINE=峰步美
Yulia Yosephin SUSANTO=尤利亚
Lyanny Alessandra MAINAKY=莉昂丽
Choirunnisa CHOIRUNNISA=科尔伦尼莎
Ruselli HARTAWAN=鲁塞莉
ZHANG Yi Man=张艺曼
Saena KAWAKAMI=川上纱惠奈
CHUA Hui Zhen Grace=蔡惠珍
Disha GUPTA=笛莎
CHIANG Ying Li=江颖丽
Mugdha AGREY=阿格瑞
Sabrina JAQUET=贾奎特
LEE Ying Ying=李盈盈
GAO Fang Jie=高昉洁
Carolina MARIN=马琳
Crystal PAN=潘欣欣
Daniela MACIAS=马西亚斯
Brittney TAM=布里特妮
Sri Krishna Priya KUDARAVALLI=克里希纳
Fabienne DEPREZ=德普莱兹
Clara AZURMENDI=克拉拉
AN Se Young=安洗莹
HUNG Yi-Ting=洪怡婷
Kristin KUUBA=库巴
Kate FOO KUNE=凯特
CHEN Su Yu=陈苏虞
Martina REPISKA=马丁娜
Julie Dawall JAKOBSEN=朱莉
SIM Yu Jin=申玉静
Anura PRABHUDESAI=阿努拉
Jordan HART=哈特
Porntip BURANAPRASERTSUK=蓬迪
WANG Yihan=王仪涵
WANG Shixian=王适娴
SUN Yu=孙瑜
Sayaka SATO=佐藤冴香
LEE Jang Mi=李张美
BAE Yeon Ju=裴延姝
LIU Xin (F)=刘鑫
Minatsu MITANI=三谷美菜津
Yui HASHIMOTO=桥本由衣
WANG Lin=王琳
ZHOU Mi=周蜜
Tine BAUN=蒂内·鲍恩
PI Hongyan=皮红艳
XIE Xingfang=谢杏芳
JIANG Yanjiao=蒋燕皎
LU Lan=卢兰
WANG Chen=王晨
ZHU Lin=朱琳
Juliane SCHENK=朱利安·申克
Petya NEDELCHEVA=佩特娅·内德尔特切娃
Salakjit PONSANA=莎拉姬·波萨娜
YAO Jie=姚洁
Eriko HIROSE=广濑荣理子
BAE Seung Hee=裴昇熙
Ella DIEHL=艾拉
KIM Moon Hi=金纹希
CHENG Shao Chieh=郑韶婕
HAN Li=韩利
Lindaweni FANETRI=琳达韦尼
Adrianti FIRDASARI=阿丽央蒂
WANG Xin=汪鑫
WANG Zhi Yi=王祉怡
Alisa Juleisy ACOSTA=阿利萨

Marcus Fernaldi GIDEON=费尔纳迪
Kevin Sanjaya SUKAMULJO=苏卡穆约
LIU Cheng=刘成
ZHANG Nan=张楠
LEE Yang=李洋
WANG Chi-Lin=王齐麟
Bodin ISARA=博丁
Maneepong JONGJIT=玛尼蓬
Kim ASTRUP=索伦森
Anders Skaarup RASMUSSEN=安德斯
Wahyu Nayaka ARYA PANGKARYANIRA=瓦优·纳亚卡
Ade Yusuf SANTOSO=阿德尤索
LU Ching Yao=卢敬尤
YANG Po Han=杨博涵
Aaron CHIA=谢定峰
SOH Wooi Yik=苏伟译
Hiroyuki ENDO=远藤大由
Yuta WATANABE=渡边勇大
ONG Yew Sin=王耀昇
TEO Ee Yi=张耀宇
Berry ANGRIAWAN=安格利万
Hardianto HARDIANTO=哈迪安托
GOH V Shem=吴蔚昇
TAN Wee Kiong=陈蔚强
Fajar ALFIAN=法加尔
Muhammad Rian ARDIANTO=阿德里安托
KO Sung Hyun=高成炫
SHIN Baek Cheol=申白喆
ATTRI Manu=埃特里
REDDY B. Sumeeth=雷迪
OU Xuan Yi=欧烜屹
REN Xiang Yu=任翔宇
KIM Gi Jung=金基正
LEE Yong Dae=李龙大
LIAO Min Chun=廖敏竣
SU Ching Heng=苏敬恒
Tinn ISRIYANET=伊斯里亚纳特
Kittisak NAMDASH=南达什
HAN Cheng Kai=韩呈恺
ZHOU Hao Dong=周昊东
CHOI SolGyu=催率圭
SEO Seung Jae=徐承宰
Mathias BOE=鲍伊
Carsten MOGENSEN=摩根森
Takuro HOKI=保木卓朗
Yugo KOBAYASHI=小林优吾
Takeshi KAMURA=嘉村健士
Keigo SONODA=园田启悟
Takuto INOUE=井上拓斗
Yuki KANEKO=金子祐树
Vladimir IVANOV=索松诺夫
Ivan SOZONOV=伊万诺夫
Marcus ELLIS=M·埃得斯
Chris LANGRIDGE=兰格瑞奇
Mohammad AHSAN=阿山
Hendra SETIAWAN=塞蒂亚万
Mark LAMSFUSS=拉姆斯富斯
Marvin SEIDEL=塞德尔
Jelle MAAS=马斯
Robin TABELING=塔博林
HE Ji Ting=何济霆
TAN Qiang=谭强
LI Jun Hui=李俊慧
LIU Yu Chen=刘雨辰
Akbar Bintang CAHYONO=阿克巴
Simon Wing Hang LEUNG=梁永亨
Mitchell WHELLER=米切尔
Jason Anthony HO-SHUE=何舒
Nyl YAKURA=矢仓尼
YOO Yeon Seong=柳延星
Mahiro KANEKO=金子真大
Yunosuke KUBOTA=久保田友之祐
GOH Sze Fei=吴思飞
Nur IZZUDDIN=伊祖丁
LEE Jhe-Huei=李哲辉
YANG Po-Hsuan=杨博轩
Hiroki OKAMURA=中村弘树
Masayuki ONODERA=小野寺
Akira KOGA=古贺辉
Taichi SAITO=斋藤太一
Satwiksairaj RANKIREDDY=兰基雷迪
Chirag SHETTY=休提
Ricky KARANDASUWARDI=苏华迪
Angga PRATAMA=普拉塔玛
HUANG Kai Xiang=黄凯祥
WANG Ze Kang=任翔宇
Kittinupong KEDREN=基丁柳蓬
Mohamad Arif Ab Latif ARIF=阿里夫
Nur Mohd Azriyn Ayub AZRIYN=阿尤布
CHOOI Kah Ming=徐家铭
LOW Juan Shen=刘隽程
Phillip CHEW=周菲利
Ryan CHEW=周赖安
M.R. ARJUN=阿琼
Ramchandran SHLOK=沙尔洛
Sabar Karyaman GUTAMA=咖塔曼
Min Hyuk KANG=姜敏赫
KIM Won Ho=金元昊
Mads Pieler KOLDING=科丁
DI Zi Jian=邸子键
WANG Chang=王昶
Sean VENDY=文迪
David DAUGAARD=大卫
Frederik SØGAARD=莫滕森
Alexander DUNN=亚历山大
Adam HALL=亚当
Jones Ralfy JANSEN=扬森
Peter KAESBAUER=卡斯巴尔
KAN Chao Yu=甘超宇
Chi-Hung LIAO=廖启宏
Lopez ANDRES=洛佩兹
Luis Armando MONTOYA NAVARRO=路易斯·阿曼多
Jacco ARENDS=阿伦斯
Ruben JILLE=鲁本
CHANG Ko-Chi=张凯量
LU Chia Pin=陆家斌
LIANG Weikeng=梁伟铿
SHANG Yi Chen=商亦辰
Mads CONRAD-PETERSEN=彼德森
Duncan YAO=邓肯
Bjarne GEISS=比亚内
Jan Colin VÖLKER=科林
Supak JOMKOH=苏帕克
Wachirawit SOTHON=所通
CHEN Hung Ling=陈宏麟
Markis KIDO=马基斯
Kien Keat KOO=古健杰
TAN Boon Heong=陈文宏
CHUNG Jae Sung=郑在成
CAI Yun=蔡赟
FU Haifeng=傅海峰
Mohd Zakry ABDUL LATIF=查基利
Mohd Fairuzizuan MOHD TAZARI=法鲁兹祖安
Alvent Yulianto CHANDRA=阿尔文
Hendra Aprida GUNAWAN=亨德拉·古纳万
Lars PAASKE=帕斯克
Jonas RASMUSSEN=拉斯姆森
Tan Fook CHOONG=钟腾福
Wan Wah LEE=李万华
Nathan ROBERTSON=罗布森
Anthony CLARK=克拉克·安东尼
GUO Zhendong=郭振东
XU Chen=徐晨
Teik Chai GAN=颜徳财
Bin Shen TAN==陈斌生
Howard BACH=白国豪
Tony GUNAWAN=吴俊明
Yonathan Suryatama DASUKI=约纳丹·苏亚达玛
Rian SUKMAWAN=里安·苏马万
LIN Yu Lang=林祐琅
Bona SEPTANO=波纳
JIAMING Tao=陶嘉明
SUN Junjie=孙君杰
Hirokatsu HASHIMOTO=桥本博且
Noriyasu HIRATA=平田典靖
CHAI Biao=柴飚
FANG Chieh Min=方介民
LEE Sheng Mu=李胜木
K. T. Rupesh Kumar=古玛·奴别
Sanave THOMAS=沙纳威·汤姆斯
CHO Gun Woo=曹建雨
KWON Yi Goo=权伊九
Ingo KINDERVATER=金德沃克
Johannes SCHOETTLER=约翰尼斯
Kenichi HAYAKAWA=早川贤一
Naoki KAWAMAE=川前直树
Shoji SATO=佐藤翔治
LIU Xiaolong=刘小龙
QIU Zihan=邱子瀚
HONG Wei=洪炜
SHEN Ye=沈烨
KIM Sa Rang=金沙朗
Thien How HOON=云天豪
Rian Agung SAPUTRO=萨普特拉
TSAI Chia Hsin=蔡佳欣
Andrew ELLIS=安德鲁·埃利斯
LIM Khim Wah=林钦华
Andrei ADISTIA=安德烈
Kenta KAZUNO=数野健太
Kazushi YAMADA=山田和司


Yuki FUKUSHIMA=福岛由纪
Sayaka HIROTA=广田彩花
NG Tsz Yau=吴芷柔
YUEN Sin Ying=袁倩瀅
Emma KARLSSON=艾玛
Johanna MAGNUSSON=约翰娜
Emilie LEFEL=拉菲尔
Anne TRAN=安妮
Gabriela STOEVA=加夫列拉
Stefani STOEVA=斯托伊娃
DU Yue=杜玥
LI Yin Hui=李菌晖
CHEN Lu=陈露
XU Ya=徐涯
Puttita SUPAJIRAKUL=普缇塔
Sapsiree TAERATTANACHAI=沙西丽
Greysia POLII=波莉
Apriyani RAHAYU=拉哈尤
Chloe BIRCH=比尔切
Lauren SMITH=L·史密斯
DONG Wen Jing=董文静
FENG Xue Ying=冯雪颖
NG Wing Yung=吴咏瑢
YEUNG Nga Ting=杨雅婷
CHEN Qing Chen=陈清晨
JIA Yi Fan=贾一凡
Rachel HONDERICH=瑞秋
Kristen TSAI=蔡宛廷
Jongkolphan KITITHARAKUL=基蒂塔拉库尔
Rawinda PRAJONGJAI=拉温达
Delphine DELRUE=德尔吕
Lea PALERMO=巴莱尔莫
LI Wen Mei=李汶妹
ZHENG Yu=郑雨
Selena PIEK=皮克
Cheryl SEINEN=塞尔宁
Della Destiara HARIS=哈里斯
Tania Oktaviani KUSUMAH=塔尼亚
LEE So Hee=李绍希
SHIN Seung Chan=申昇瓒
KIM So Yeong=金昭映
KONG Hee Yong=孔熙容
Johanna GOLISZEWSKI=格里斯威斯基
Lara KAEPPLEIN=劳拉
Ayako SAKURAMOTO=樱本绚子
Yukiko TAKAHATA=高畑佑纪子
Mayu MATSUMOTO=永原和可那
Wakana NAGAHARA=松本麻佑
JAKKAMPUDI Meghana=梅加纳
S RAM Poorvisha=拉姆
Ekaterina BOLOTOVA=博络托娃
Alina DAVLETOVA=艾琳娜
Ashwini PONNAPPA=蓬纳帕
REDDY N. Sikki=斯基·瑞迪
Shiho TANAKA=田中志穗
Koharu YONEMOTO=米元小春
Ni Ketut Mahadewi ISTARANI=玛哈德维
Rizki Amelia PRADIPTA=普拉蒂普塔
Maiken FRUERGAARD=迈肯
Sara THYGESEN=蒂格森
CHANG Ye Na=张艺娜
JUNG Kyung Eun=郑景银
Misaki MATSUTOMO=松友美佐纪
Ayaka TAKAHASHI=高桥礼华
Nami MATSUYAMA=松山奈未
Chiharu SHIDA=志田千阳
BAEK Ha Na=白荷娜
KIM Hye Rin=金惠琳
CHOW Mei Kuan=邹美君
LEE Meng Yean=李明晏
Chayanit CHALADCHALAM=伽芮恰伦
Phataimas MUENWONG=穆恩旺
HSIEH Pei Shan=谢沛珊
LIN Xiao Min=林筱闵
LEE Chia Hsin=李佳馨
LIN Jhih Yun=林芝昀
HSU Ya Ching=许雅晴
HU Ling Fang=胡绫芳
Yulfira BARKAH=尤尔费拉
Jauza Fadhila SUGIARTO=乔萨
Setyana MAPASA=塞蒂亚娜
Gronya SOMERVILLE=格罗娅
Agatha IMANUELA=阿加莎
Siti Fadia Silva RAMADHANTI=西蒂
LIU Xuan Xuan=刘玄炫
XIA Yu Ting=夏玉婷
PAI Yu Po=白驭珀
WU Ti Jung=吴玓蓉
Vivian HOO=许嘉雯
YAP Cheng Wen=叶程雯
Anggia Shitta AWANDA=安洁
Pia Zebadiah BERNADET=碧雅
KIM Hye Jeong=金惠贞
Ariel LEE=李艾莉
Sydney LEE=西德尼
Pacharapun CHOCHUWONG=帕冲攀
Kittipak DUBTHUK=达布萨克
CHANG Ching Hui=张净惠
Virni PUTRI=普特里
Anna Ching Yik CHEONG=安娜程奕翔
LIM Chiew Sien=林秋仙
Saori OZAKI=尾崎沙织
Akane WATANABE=渡边茜
CHEN Jia Yuan=陈嘉园
CHEN Ying Ying=陈颖颖
Alexandra BØJE=博尔
Mette POULSEN=波尔森
CHEN Xiao Fei=陈笑菲
ZHANG Shu Xian=张殊贤
Danica NISHIMURA=丹妮卡
Akane ARAKI=荒木茜羽
Riko IMAI=今井莉子
Eva JANSSENS=伊娃
Kilasu OSTERMEYER=奥丝黛梅叶
Jenna GOZALI=珍纳·戈扎利
Megumi TARUNO=樽野惠
Eva LEE=李意恒
Paula Lynn OBANANA=奥巴娜娜
HUANG Jia=黄佳
YU Xiao Han=于小含
LI Zi Qing=李子晴
TENG Chun Hsun=邓淳薰
LEE Chih Chen=李志晨
Julie MACPHERSON=朱莉
Jenny MOORE=珍妮穆尔
Nadya MELATI=美拉提
Tiara Rosalia NURAIDAH=蒂亚拉
ZHAO Tingting=赵婷婷
ZHANG Yawen=张亚雯
Eei Hui CHIN=陈仪慧
Pei Tty WONG=黄佩蒂
CHENG Shu=成淑
ZHAO Yunlei=赵芸蕾
DU Jing=杜婧
YU Yang (F)=于洋
HA Jung Eun=河贞恩
KIM Min Jung=金旼贞
LEE Hyo Jung=李孝贞
LEE Kyung Won=李敬元
CHENG Wen Hsing=程文欣
CHIEN Yu Chin=简毓瑾
MA Jin=马晋
WANG Xiaoli=王晓理
Lena FRIER KRISTIANSEN=克里斯蒂安森
Kamilla Rytter JUHL=卡米拉
Shendy Puspa IRAWATI=伊拉瓦蒂
Meiliana JAUHARI=梅里亚娜·娇哈里
YANG Wei=杨维
ZHANG Jiewen=张洁雯
GAO Ling=高崚
WEI Yili=魏轶力
Nitya Krishinda MAHESWARI=马赫斯瓦里
PAN Pan=潘攀
TIAN Qing=田卿
Valeria SOROKINA=弗拉迪米尔
Nina VISLOVA=丽娜·维斯洛娃
Shinta Mulia SARI=欣塔·穆利亚
Lei YAO=姚蕾
Mizuki FUJII=藤井瑞希
Reika KAKIIWA=垣岩令佳
Helle NIELSEN=尼尔森
Marie ROEPKE=马丽恩·罗布克
Duanganong AROONKESORN=当甲农
Kunchala VORAVICHITCHAIKUL=库查拉
Anastasia RUSSKIKH=安娜斯塔西娅
Peeraya MUNKITAMORN=皮让娅
Miyuki MAEDA=前田美顺
Satoko SUETSUNA=末纲聪子
Shizuka MATSUO=松尾静香
Mami NAITO=内藤真实
Jwala GUTTA=嘉娃拉.古达
Laura CHOINET=劳拉·舒瓦内
Rie ETOH=江藤理惠
Yu WAKITA=胁田侑
Lotte JONATHANS=洛特·乔纳坦
Paulien VAN DOOREMALEN=保琳
Sandra MARINELLO=桑德拉
Birgit OVERZIER=奥齐尔
POON Lok Yan=潘乐恩
Vita MARISSA=维塔·玛丽莎
KIM Ha Na=金荷娜
Line DAMKJAER KRUSE=莱恩·丹穆凯尔
Anneke Feinya AGUSTIN=安妮克·菲亚
TANG Jin Hua=汤金华
XIA Huan=夏欢
BAO Yixin=包宜鑫
ZHONG Qianxin=钟倩欣
CHOI Hye In=崔惠仁
WOON Khe Wei=温可微
GO Ah Ra=高雅罗
Aprilsasi Putri LEJARSAR VARIELLA=阿皮莎丝
Gebby Ristiyani IMAWAN=盖比·里斯蒂亚妮
Eefje MUSKENS=埃菲耶·穆斯肯斯
LUO Ying=骆赢
LUO Yu=骆羽
TANG Yuanting=唐渊渟
YOO Chae Ran=柳海媛
OU Dongni=区冬妮
Naoko FUKUMAN=福万尚子
Kurumi YONAO=与犹胡桃
Rosyita Eka PUTRI SARI=罗西尔塔
Nairoby Abigail JIMENEZ=内罗比
Bermary Altagracia POLANCO MUNOZ=波兰科
Emily KAN=艾米丽
Vinson CHIU=邱文森
PENG Qin=彭沁
DONG Wei Jie=龚伟杰
GUO Xin Wa=郭新娃
CHEN Long Zhu=陈龙珠
HE Xin Ying=何欣颖
KANG Yue=康月
Vania Arianti SUKOCO=瓦尼亚
Metya Inayah CINDIANI=玛蒂亚


ZHENG Si Wei=郑思维
HUANG Ya Qiong=黄雅琼
Evgenij DREMIN=德雷明
Evgenia DIMOVA=迪莫娃
Kohei GONDO=权藤公平
Ayane KURIHARA=栗原文音
Niclas NOHR=尼克拉斯
Sara THYGESEN=蒂格森
Chris ADCOCK=爱德考克
Gabrielle ADCOCK=加布里
CHEN Tang Jie=陈堂杰
PECK Yen Wei=白燕薇
Ben LANE=莱恩
Jessica PUGH=杰西卡
Marvin SEIDEL=塞德尔
Linda EFLER=琳达
Dechapol PUAVARANUKROH=德差波尔
Sapsiree TAERATTANACHAI=沙西丽
Yuki KANEKO=金子祐树
Misaki MATSUTOMO=松友美佐纪
Rodion ALIMOV=阿利莫夫
Alina DAVLETOVA=艾琳娜
Sam MAGEE=山姆
Chloe MAGEE=克洛伊
Hafiz FAIZAL=费泽尔
Gloria Emanuelle WIDJAJA=维德佳佳
Praveen JORDAN=乔丹
Melati Daeva OKTAVIANTI=梅拉蒂
Rinov RIVALDY=里瓦尔迪
Pitha Haningtyas MENTARI=皮塔
Mark LAMSFUSS=拉姆斯富斯
Isabel HERTTRICH=伊莎贝尔
Tontowi AHMAD=艾哈迈德
Winny Oktavina KANDOW=温尼
Alfian Eko PRASETYA=艾菲
Marsheilla Gischa ISLAMI=马尔希拉
Takuro HOKI=保木卓朗
Wakana NAGAHARA=永原和可那
CHAN Peng Soon=陈炳顺
GOH Liu Ying=吴柳萤
SEO Seung Jae=徐承宰
CHAE YuJung=蔡侑玎
LU Kai=鲁恺
CHEN Lu=陈露
Mathias CHRISTIANSEN=佩蒂森
Christinna PEDERSEN=克里斯蒂安森
Yuta WATANABE=渡边勇大
Arisa HIGASHINO=东野有纱
Ronald RONALD=亚历山大
Annisa SAUFIKA=安妮萨
GOH Soon Huat=吴顺发
LAI Shevon Jemie=赖洁敏
HE Ji Ting=何济霆
DU Yue=杜玥
Marcus ELLIS=M·埃利斯
Lauren SMITH=L·史密斯
CHANG Tak Ching=张德正
NG Wing Yung=吴咏瑢
Pranaav Jerry CHOPRA=乔普拉
REDDY N. Sikki=斯基·瑞迪
TAN Kian Meng=陈健铭
LAI Pei Jing=赖沛君
WANG Yi Lyu=王懿律
HUANG Dong Ping=黄东萍
TSENG Min Hao=曾敏豪
HSIEH Pei Shan=谢沛珊
LEE Chia Hsin=李佳馨
HU Ling Fang=胡绫芳
TANG Chun Man=邓俊文
TSE Ying Suet=谢影雪
Huaidong TANG=唐怀东
Jodee VEGA=约德维加
CHENG Chi Ya=程琪雅
Joshua HURLBURT-YU=约书亚
Josephine WU=吴宛菱
ZHOU Chao Min=周超敏
YEUNG Ming Nok=杨铭诺
EOM Hye Won=严惠媛
Gronya SOMERVILLE=格罗娅
YANG Ching Tun=杨景惇
Mathew FOGARTY=佛哥迪
Isabel ZHONG=伊莎贝拉
Nipitphon PHUANGPHUAPET=尼迪蓬
Savitree AMITRAPAI=阿米达拜
Tuan Duc DO=杜俊德
Nhu Thao PHAM=范茹草
Rusydina Antardayu RIODINGIN=利奥丁金
Danny Bawa CHRISNANTA=克里斯南塔
TAN Wei Han=陈薇涵
Saurabh SHARMA=夏尔马
Anoushka PARIKH=安诺舒卡
Venkat Gaurav PRASAD=拉夫
Juhi DEWANGAN=蒂婉荌
HEE Yong Kai Terry=许永凯
WONG Jia Ying Crystal=黄嘉盈
Bimo Adi PRAKOSO=帕克首
Putri Sari Dewi CITRA=慈塔拉
Thom GICQUEL=吉奎尔
Ronan LABAR=拉巴尔
Audrey MITTELHEISSER=奥德丽
Debby SUSANTO=苏珊托
Jenny MOORE=邱恺翔
Breanna CHI=布雷纳·池
Howard SHU=舒之颢
CHANG Hsin Tien=张莘恬
PO Li-Wei=柏礼维
Callum HEMMING=卡勒姆
Sattawat PONGNAIRAT=庞拉尔莱特
Supissara PAEWSAMPRAN=素比莎拉·飘讪攀
Cesar Adonis BRITO GONZALEZ=塞萨尔
EOM Hye Won=严惠媛
Howard SHU=舒之显
Mathias CHRISTIANSEN=马蒂亚斯·克里斯蒂安森
Phillip CHEW=菲利浦
Ronan LABAR=罗南·拉巴尔
Ben LANE=本·莱恩
Jessica PUGH=杰西卡·皮尤
Nelson JAVIER=纳尔逊·哈维尔
