JPN=日本
CHN=中国
DEN=丹麦
TPE=中国台北
KOR=韩国
INA=印尼
IND=印度
HKG=中国香港
THA=泰国
MAS=马来西亚
NED=荷兰
FRA=法国
ENG=英国
ISR=以色列
SGP=新加坡
BRA=巴西
ESP=西班牙
VIE=越南
RUS=俄罗斯
CAN=加拿大
GER=德国
SWE=瑞典
FIN=芬兰
AUT=奥地利
EST=爱沙尼亚
CUB=古巴
HUN=匈牙利
IRL=爱尔兰
POL=波兰
CZE=捷克
TUR=土耳其
CRO=克罗地亚
MEX=墨西哥
ITA=意大利
UKR=乌克兰
GUA=危地马拉
AZE=阿塞拜疆
USA=美国
SCO=苏格兰
BEL=比利时
BUL=保加利亚
SUI=瑞士
MRI=毛里求斯
SVK=斯洛伐克
WAL=威尔士
NGR=尼日利亚
PER=秘鲁
EGY=埃及
ISL=冰岛
SRI=斯里兰卡
POR=葡萄牙
LUX=卢森堡
AUS=澳大利亚
NZL=新西兰
NEP=尼泊尔
SRB=塞尔维亚
ROU=罗马尼亚
SLO=斯洛文尼亚
KAZ=哈萨克斯坦
MDV=摩尔多瓦
MAC=中国澳门
ZAM=赞比亚
JAM=牙买加
MGL=蒙古
NOR=挪威
GHA=加纳
MLT=马耳他
GRE=希腊
DOM=多米尼加
CHI=芝加哥
BRN=巴林
UZB=乌兹别克斯坦
ALG=阿尔及利亚
BAR=巴巴多斯
CRC=哥斯达黎加
LAT=拉脱维亚
PAN=巴拿马
LAO=老挝
PAK=巴基斯坦
CIV=科特迪瓦
IRI=伊朗
JOR=约旦
MDA=摩尔多瓦
SUR=苏里南
BRU=文莱
UGA=乌干达
BEN=贝宁
NCL=新喀里多尼亚
TOG=多哥
BAN=孟加拉国
VEN=委内瑞拉
BOT=博茨瓦纳
SEY=塞舌尔
CMR=喀麦隆
SYR=叙利亚
LTU=立陶宛
GRL=格陵兰
BLR=白俄罗斯
ARM=亚美尼亚
RSA=南非
COL=哥伦比亚
AFG=阿富汗
KSA=沙特
FIJ=斐济
GUY=圭亚那
CYP=塞浦路斯
UAE=阿联酋
COK=库克群岛
KEN=肯尼亚
IRQ=伊拉克
PYF=法属波利尼西亚
GUM=关岛
SAM=萨摩亚
COD=刚果
ESA=萨尔瓦多