PRINCESS SIRIVANNAVARI THAILAND MASTERS=泰国大师赛
BARCELONA SPAIN MASTERS=西班牙大师赛
YONEX GERMAN OPEN=德国公开赛
YONEX SWISS OPEN=瑞士公开赛
BARFOOT & THOMPSON NEW ZEALAND OPEN=新西兰公开赛
CROWN GROUP AUSTRALIAN OPEN=澳大利亚公开赛
YONEX US OPEN=美国公开赛
YONEX CHINESE TAIPEI OPEN=中国台北公开赛
MACAU OPEN=中国澳门公开赛
KOREA MASTERS=韩国大师赛
PERODUA MALAYSIA MASTERS=马来西亚大师赛
DAIHATSU INDONESIA MASTERS=印尼大师赛
YONEX-SUNRISE INDIA OPEN=印度公开赛
SINGAPORE OPEN=新加坡公开赛
TOYOTA THAILAND OPEN=泰国公开赛
KOREA OPEN=韩国公开赛
YONEX-SUNRISE HONG KONG OPEN=香港公开赛
CELCOM AXIATA MALAYSIA OPEN=马来西亚公开赛
DAIHATSU YONEX JAPAN OPEN=日本公开赛
DANISA DENMARK OPEN=丹麦公开赛
YONEX FRENCH OPEN=法国公开赛
FUZHOU CHINA OPEN=中国公开赛
YONEX ALL ENGLAND OPEN BADMINTON CHAMPIONSHIPS=全英赛
BLIBLI INDONESIA OPEN=印尼公开赛
VICTOR CHINA OPEN=中国公开赛
HSBC BWF WORLD TOUR FINALS=世界巡回赛总决赛
BWF WORLD SENIORS CHAMPIONSHIPS=世老赛
TOTAL BWF WORLD CHAMPIONSHIPS=世锦赛
BWF WORLD JUNIOR CHAMPIONSHIP=世青赛
TOTAL BWF Sudirman Cup=苏迪曼杯
BWF WORLD JUNIOR MIXED TEAM CHAMPIONSHIPS=青年混合团体锦标赛
TOTAL BWF THOMAS & UBER CUP FINALS=汤尤杯
YOUTH OLYMPIC GAMES RELAY TEAM=青年奥林匹克团体赛
LI NING BWF WORLD JUNIOR MIXED TEAM CHAMPIONSHIPS=世青混合团体锦标赛
OLYMPIC GAMES BADMINTON=奥运会